0	0	960	960	4	0						
0	0	480	480	0	0						
480	0	480	480	0	0						
0	480	480	480	4	0						
0	480	240	240	0	1	0					
240	480	240	240	0	0						
0	720	240	240	0	5	0	1	2	3	6
240	720	240	240	0	8	1	4	5	6	12	13	14	18
480	480	480	480	4	0						
480	480	240	240	0	0						
720	480	240	240	0	1	11					
480	720	240	240	0	8	1	7	8	6	15	16	17	19
720	720	240	240	0	5	1	9	10	11	6	
